|																												                                                                    
###################################################################################
#                                                                                 #
#                                                                                 #
#                                                                                 #
#                                                                                 #
#                                                                                 #
#                                                                                 #
#                                                                                }#
#                                                                                 #
#{                                                                                #
#                                                                                }#
#                                                                                 #
#                                                                                 #
#                                                                                 #
#                                                                                 #
#                       ###########################                            ####
#                       #`````````````````````````#                           }#```
#{                      #`````````````````````````#                            #```
#                       #`````````````````````````#                            #```
#                       #`````````````````````````#                            #```
#                       #`````````````````````````#                            #```
#########################`````````````````````````##############################```