##########################################################################
#                                                                        #
#                                                                        #
#                                                                        #
#                                                                        #
#                                                                        #
#                                                                        #
#                                                                       }#
#                                                                        #
#{                                                                       #
#                                                                       }#
#                                                                        #
#                                                                        #
#                                                                        #
#                                                                        #
#                       ###########################                   ####
#                       #`````````````````````````#                  }#```
#{                      #`````````````````````````#                   #```
#                       #`````````````````````````#                   #```
#                       #`````````````````````````#                   #```
#                       #`````````````````````````#                   #```
#########################`````````````````````````#####################```